Access Mode=Tilgangsmodus
Add another Path, Port, Variable, Label or Device=Legg til Sti, Port, Variabel, Merkelapp eller Enhet
Add Configuration=Legg til konfigurasjon
Add=Legg til
Additional Requirements=Tilleggskrav
Always=Alltid
App to Host=Program til Vert
Application=Program
apply update=Legg til oppdatering
Are you sure=Er du sikker
Array must be Started to view Docker containers=Arrayet må være **startet** for å se Dockercontainere
Autostart=Autostart
Back=Tilbake
Backup=Sikkerhetskopi
Beta=Beta
Books=Bøker
By=Av
Categories=Kategorier
Check for Updates=Se etter oppdateringer
Cloud=Sky
Config Type=Konfigurationstype
Configuration not found=Konfigurasjon ikke funnet
Connection Type=Tilkoblingstype
Console shell command=Konsoll shell kommando
Container ID=Container ID
Container Path=Container sti
Container Port=Container port
Container Size=Container størrelse
Container=Container
CPU Memory load=CPU minnelast
CPU Pinning=CPU trådfordeling
Created=Opprettet
Crypto Currency=Kryptovaluta
Default Value=Standardverdi
Device=Enhet
Display=Skjerm
DNS=DNS
Docker Containers=Docker Containere
Docker Hub URL=Docker HUB URL
Docker Service failed to start=Dockertjenester kunne ikke starte
Downloaders=Nedlastere
Drivers=Driver
Edit Configuration=Rediger konfigurasjon
Exited=Avsluttet
Extra Parameters=Ekstra parametere
Fixed IP address=Låst IP-adresse
force update=tving oppdatering
FTP=FTP
Game Servers=Spillservere
healthy=frisk
Hide Buttons=Skjul knapp
Hide docker allocations=Skjul dockertildelinger
Hide more settings=Skjul flere innstillinger
Home Automation=Hjemautomatisering
Host Path=Vertsti
Host Port=Vertsport
HT=HT
Icon URL=Ikon URL
Image ID=Bilde ID
Key=Nøkkel
Label=Etikett
LAN IPPort=LAN IP:Port
Lock sortable items=Lås sorterbare elementer
Management=Styring
MediaApp=Mediaprogram
MediaServer=Mediaserver
Messenger=Meldinger
Missing parameters=Mangler parametere
Music=Musikk
Network Type=Nettverkstype
No Docker containers installed=Antall Dockercontainere som er installert
None Listed=Ingen listed opp
of=av
orphan image=Avsondet bildefil
Other=Annet
Overview=Oversikt
Path=Sti
Pause All=Pause alle
Photos=Bilder
Port Mappings=Portkobling
Port=Port
Post Arguments=Avslutningsargumenter
Privileged=Priviligert
Productivity=Produktivitet
Project Page=Prosjektside
Proxy=Mellomtjener
Pulling image=Henter bildefil
Read Me First=Les meg først
Read Only - Shared=Kun lesetilgang - Delt
Read Only - Slave=Kun lesetilgang - Slave
Read Only=Kun lesetilgang
ReadWrite - Shared=Lese-/skrivetilgang - Delt
ReadWrite - Slave=Lese-/skrivetilgang - Slave
rebuild ready=gjenoppbygging klar
rebuilding=gjenoppbygger
Remove template=Fjern mal
Removing container=Fjerner container
Removing orphan image=Fjerner avsondet bildefil
Repository=Depot
Required=Påkrevd
Reset sorting=Resett sortering
Resume All=Gjenoppta alle
Save=Lagre
Select a template=Velg en mal
Select categories=Velg kategori
Show docker allocations=Vis dockertildelinger
Show more settings=Vis flere innstillinger
Stable=Stabil
Start All=Start alle
starting up containers=starter containere
Stop All=Stopp alle
Stopping container=stopper containere
Successfully removed container=Fjerning av containere var vellykket
Successfully removed orphan image=Fjerning av avsondede bildefiler var vellykket
Successfully stopped container=Stopping av containere var vellykket
Support Thread=Brukerstøtte
Template URL=Mal URL
Template=Mal
The command failed=Kommandoen feilet
The command finished successfully=Kommandoen fullførte
TOTAL DATA PULLED=TOTALT DATA HENTET
Total size=Total størrelse
Unknown action=Ukjent handling
Unlock sortable items=Lås opp sorterbare elementer
Update All=Oppdater alle
update ready=oppdatering er klar
Value=Verdi
Variable=Variabel
Video=Video
Voip=VoIP
Volume Mappings=Områdekoblinger
wait=vent
Was this container created using this plugin=Ble denne containeren skapt med dette programtillegget
Web=Web
WebUI=Webgrensesnitt
Writable=Skrivetilgang

; Note: December 28, 2024 - 21 missing translations
3rd Party=
Addresses=
available=
Compose=
Container IP=
Container not running=
DERP Relay=
Error gathering Tailscale information from container=
Exit Node=
Expired RenewDisable key expiry=Expired! Renew/Disable key expiry!
Hostname=
Is Exit Node=
Key Expiry=
Online=
Please check the logs and refresh the page=
Please check the logs=
Real Hostname=
Routes=
Tailscale=
update available=
URL=
