A format is NEVER part of a data recovery or disk rebuild process and if done in such circumstances will normally lead to loss of all data on the disks being formatted=En formatering er **ALDRI** en del av datagjenoppretting eller en gjenoppbygningsprosess og vil kunne lede til tap av data på diskene som blir formatert.
Aborted=Avbrutt
Action=Handling
Add Pool=Legg til diskgruppe
Add=Legg til
All existing data on this device will be OVERWRITTEN when array is Started=Alle eksiterende data på denne enheten vil bli SLETTET når arrayet blir startet
Array Devices=Arrayenheter
Array of %s devices=%s enheter i arrayet
Array Operation=Lagringsoperasjon
Attribute Name=Attributtnavn
Attributes=Attributter
auto=auto
Autotrim=Autotrim
Balance Status=Balansestatus
Balance=Balanse
Blacklisted=Svartelistet
Boot Device=Oppstartsenhet
Boot system in UEFI mode=Start systemet i UEFI-modus
btrfs balance status=btrfs balansestatus
btrfs check status=btrfs kontrollstatus
BTRFS operation is running=BTRFS-operasjoner kjører
btrfs scrub status=btrfs rengjøringsstatus
Canceled=Avbrutt
Cannot contact key-server Please check your=Kan ikke kontakt lisensserver. Vennligst sjekk din
Caution=**Caution**
Capabilities not available=Egenskaper er ikke tilgjengelige
Capabilities=Egenskaper
Check Filesystem Status=Status på filsystemsjekk
Clear Stats=Nullstill statistikk
Clearing in progress=Nullstilling pågår
Click on FLASH above this message=Klikk på **FLASH** over denne meldingen
Click to spin down device=Trykk for å spinne ned disk
Click to spin up device=Trykke for å spinne opp disk
Comments=Kommentarer
complete=fullført
Completed without error=Fullført uten feil
completed=fullført
Compression=Komprimering
Configuration valid=Konfigurasjonen er gyldig
Convert to raid0 mode=Konverter til raid0-modus
Convert to raid1 mode=Konverter til raid1-modus
Convert to raid10 mode=Konverter til raid10-modus
Convert to raid1c3 mode=Konverter til raid1c3 modus
Convert to raid1c4 mode=Konverter til raid1c4 modus
Convert to raid5 mode see help=Konverter til raid5-modus *se hjelp
Convert to raid6 mode see help=Konverter til raid6-modus *se hjelp
Convert to single mode=Konverter til enkeltmodus
Copying=Kopierer
corrected=korrigert
Create an empty file system on the disks shown as Unmountable discarding all data currently on the disks and update parity to reflect this=Opprett et tomt filsystem på diskene vist som Unmountable, kast alle data på diskene og oppdater paritet for å gjenspeile dette
creating Flash backup zip file this may take several minutes=oppretter zip-fil (dette kan ta flere minutter)
Creating Flash backup=Oppretter backup av Flashenheten
Creation error=Feil ved opprettelse
Critical disk temperature threshold=Kritisk disktemperaturgrense
Critical disk utilization threshold=Kritisk diskutnyttelsesgrense
Current operation %s on %s=Gjeldende operasjon %s på **%s**
Current position=Gjeldende posisjon
Custom attributes use comma to separate numbers=Egendefinerte attributter (bruk komma for å separere verdier)
Data-Rebuild in progress=Data gjenoppbygging i gang
Date of purchase=Kjøpsdato
Date=Dato
Delete Pool=Slett diskgruppe
detected=oppdaget
Device encrypted and unlocked=Enheten er kryptert og opplåst
Device encrypted=Enheten er kryptert
Device is part of a pool=Enheten er en del av en diskgruppe
Device locked unknown error=Enheten er låst: Ukjent feil
Device locked wrong encryption key=Enheten er låst, feil krypteringsnøkkel
Device to be encrypted=Enheten blir kryptert
Disable Spin down delay to run a SMART extended self-test=Deaktiver **Spin down delay** for å kjøre en SMART utvidet selvtest
Disk in parity slot is not biggest=Disken i paritetssporet er ikke størst
Disk Log Information=Disk logginformasjon
Disk-Clear in progress=Disk-tømming i gang
Do not use reserved names=Ikke benytt reserverte navn
Do not use user share names=Ikke bruk navn som blir brukt i delte mapper
Download SMART report=Last ned SMART-rapport
Dual parity valid requires ALL disks in their original slots=For at *dobbel paritet* skal være gyldig må *alle* disker være i deres originale spor
Elapsed time=Tid brukt
Enable user share assignment=Aktiver brukermappe tilganger
encrypted=kryptert
Encryption input=Kryptering inn
Encryption status=Krypteringsstatus
enter disk index and device name as applicable to your controller=skriv inn diskindeks og enhetsnavn som gjelder for kontrolleren
Enter new key=Skriv inn ny nøkkel
Erase Device Content=Slett enhetsinnhold
Errors occurred - Check SMART report=Feil oppdaget - Sjekk SMART rapport
Estimated finish=Estimert ferdig
Estimated speed=Estimert hastighet
Existing content is permanently lost=Eksisterende innhold blir permanent fjernet
Failed=Feilet
Feature=Funksjon
File system status=Filsystem status
File system type=Filsystem type
Finding %s error=Fant **%s** feil
Finding %s errors=Fant **%s** feil
Flag=Flagg
Flash backup=Flashenhet backup
Flash device is set as public share=Flash enhet er satt som offentlig mappe
Flash Device Settings=Flashenhet innstillinger
Format Unmountable disks=Formater umonterbare disker
Formatting=Formaterer
formatting=formaterer
Free=Ledig
FS=FS
Global Configuration=Global konfigurasjon
Hide=Skjul
Identification=Identifikasjon
Identity=Identitet
if checked, Start array but do not mount disks=hvis markert, start array men ikke monter disker
If this is a new array, move the largest disk into the parity slot=Hvis dette er en ny matrise, flytt den største disken inn i *paritet*-sporet
If you are adding a new disk or replacing a disabled disk, try Parity-Swap=Hvis du skal legge til en ny eller bytte en deaktivert disk, prøv Parity-Swap
Incorrect confirmation=Ugyldig bekreftelse
Information=Informasjon
Insufficient free disk space available=Ikke nok tilgjengelig diskplass
Interrupted=Avbrutt
Invalid configuration=Ugyldig konfigurasjon
invalid device=ugyldig enhet
invalid devices=ugyldige enheter
Invalid expansion=Ugyldig utvidelse
Invalid pool name=Ugyldig navn på diskgruppe
Invalid, missing or expired=Ugyldig, mangler eller er utgått
is only available when array is Started in Maintenance mode=er kun tilgjengelig når arrayet er startet i **Vedlikeholdsmodus**
is only available when array is Started=er kun tilgjengelig når arrayet har startet
Keyfile=Nøkkelfil
Last check completed on %s=Siste sjekk ble gjennomført: **%s**
Last check incomplete on %s=Siste sjekk ble ikke fullført: **%s**
Last checked on %s=Sist sjekket: **%s**
Last SMART test result=Siste SMART testresultat
Maintenance mode=Vedlikeholdsmodus
Maintenance Mode=Vedlikeholdsmodus
Maintenance=Vedlikehold
Manufacturing date=Produksjonsdato
Menu View=Menyvisning
Minimum free space=Minimum ledig plass
mirror=speiling
Missing Cache disk=Mangler bufferdisk
Missing disk=Mangler disk
Missing key=Mangler nøkkel
Missing=Mangler
Mounted=Montert
Mover is running=Flytter kjører
network settings=netverksinnstillinger
New data disks detected=Nye datadisker oppdaget
next device=neste enhet
No array data disks have been assigned=Ingen datadisker har blitt tildelt arrayet
No data disks=Ingen datadisker
no devices=ingen enheter
No parity check history present=Ingen historikk over paritetssjekker
No self-tests logged on this disk=Ingen selvsjekker er lagret på denne disken
Not installed=Ikke installert
Not present=ikke tilgjengelig
OK=OK
Once copy completes, the array may be Started, to initiate Data-Rebuild of the disabled disk=Så fort kopieringen er fullført, kan arrayet startes og datagjenoppretting av deaktiverte disker vil begynne
operation=operasjon
Options see Help=Valgalternativer (se Hjelp)
Otherwise use the keyfile method for UTF8 input=I andre tilfeller, bruk nøkkelfilmetoden for UTF-8
Parity disks content will be overwritten=*Paritetsdiskens* innhold vil bli overskrevet
Parity is already valid=Paritet er allerede gyldig
Parity Operation History=Paritetsoperasjonshistorikk
Parity operation is running=Paritetsoperasjon kjører
Parity valid requires ALL disks to have their original content=For at paritet skal være gyldig må alle disker inneholde det originale innholdet
Parity-Check in progress=Paritetskontroll pågår
ParityRead-Check History=Paritets-/Lesekontroll historikk
Parity-Sync in progress=Paritetssynkronisering pågår
Parity-SyncData-Rebuild in progress=Paritetssynkronisering/Datagjenoppretting pågår
Partition format=Partisjonsformat
Partition size=Partisjonsstørrelse
Passed=Bestått
Passphrase=Passord
Perform full balance=Gjennomfør full balansering
Permit UEFI boot mode=Tillat UEFI-startmodus
Please change share SMB security=Vennligst endre den delte mappen SMB sine sikkerhetsinnstillinger
Please check your system settings to support UEFI boot mode=Vennligst kontroller at ditt system støtter UEFI-startmodus
Please try again=Forsøk igjen
Pool Devices=Pool enheter
Pool name already exists=Diskgruppenavnet eksisterer allerede
Pool of %s devices=Antall enheter %s i pool
Pool Status=Pool status
Preclear in progress=Forhåndssjekk pågår
previous device=forrige enhet
Printable Characters Only=Kun utskrivbare tegn
Proceed to start=Fortsett til start
Raw Value=Råverdi
Raw View=Råvisning
Read errors corrected=Lesefeil rettet
Read errors detected=Lesefeil oppdaget
Read-Check in progress=Lesesjekk pågår
Reading=Leser
Reboot in safe mode=Restart i sikkermodus
Registration Key Manager=Administrer registreringsnøkker
registration key=registreringsnøkkel
ReiserFS is deprecated, please use another file system=ReiserFS er utdatert, vennligst bruk et annet filsystem
reiserfsck status=reiserfsck status
Rename Pool=Gi diskgruppen nytt navn
Repair corrupted blocks=Reparer korrupte blokker
Replacement disk installed=Erstatningsdisk installert
Replacement disk is too small=Erstatningsdisk er for liten
Retype passphrase=Skriv inn passord på nytt
Schedule=Timeplan
Scrub Status=Scrub status
Scrub=Scrub
See %s Settings=Se %s Innstillinger
self-test in progress=Selvdiagnose pågår
Self-Test=Selvdiagnose
Server boot mode=Server oppstartsmodus
Set default boot menu=Sett standard oppstartsmodus
show passphrase=vis passord
Show=Vis
single=singel
Slots=Spor
SMART attribute notifications=SMART-attributt varslinger
SMART controller type=SMART kontroller type
SMART error log=SMART errorlogg
SMART extended self-test=SMART utvidet selvdiagnose
SMART health-check failed=SMART helsesjekk feilet
SMART notification tolerance level=SMART notifikasjonstoleransenivå
SMART notification value=SMART varsling verdi
SMART self-test history=SMART selvdiagnosehistorikk
SMART self-test in progress=SMART selvtest i gang
SMART Settings=SMART-innstillinger
SMART short self-test=SMART kort selvdiagnose
SMART status=SMART-status
Speed=Hastighet
Spin down delay=Spinn ned forsinkelse
Spin Down=Spinn ned
Spin Up=Spinn opp
Spinup groups=Spinn opp-grupper
Started, array protected=Startet, arrayet er beskyttet
Started, array unprotected=Startet, arrayet er ubeskyttet
Started, clearing=Startet, tømmer
Started, formatting=Startet, formaterer
Starting, copying=Starter, kopierer
Starting=Starter
Stopping=Stopper
Sync errors corrected=Synkroniseringsfeil rettet
Sync errors detected=Synkroniseringsfeil oppdaget
Sync errors=Synkroniseringsfeil
Sync=Synkronisering
Syslinux Configuration=Syslinux konfigurasjon
Syslinux configuration=Syslinux konfigurasjon
Temp=Temperatur
The array will be immediately available, but unprotected since parity has not been assigned=Arrayet vil bli tilgjengelig umiddelbart, men **ubeskyttet** siden det mangler en paritetsdisk
The array will be immediately available, but unprotected until Parity-Sync completes=Arrayet vil bli tilgjengelig umiddelbart, men **ubeskyttet** til paritetssynkroniseringen er fullført
The replacement disk must be as big or bigger than the original=Erstatningsdisken må være like stor eller større enn originalen
This is typically done when a new disk is added to the array to get it ready for files to be written to it=Dette er gjort når en ny disk blir lagt til arrayet for å klargjøre den for ny data
This Unraid OS release has been withdrawn and may no longer be used Please=Denne Unraid OS utgaven har blitt tilbaketrukket og bør ikke lenger brukes.
This will ERASE ALL device content=Dette vil SLETTE ALT innhold på enheten
This will ERASE content of ALL devices in the pool=Dette vil SLETTE innhold på ALLE enheter i pool
This will reboot the system=Dette vil restarte systemet
This will shutdown the system=Dette vil skru av systemet
This will stop the array=Dette vil stoppe arrayet
This will stop the running operation=Dette vil stoppe den pågående operasjonen
Threshold=Grense
Title=Tittel
Toggle readswrites display=Veksle visningen av skriv/les
Too many attached devices Please consider upgrading your=For mange tilkoblede enheter. Vurder oppgradering av din
Too many wrong andor missing disks=For mange disker som enten har feil eller mangler
Total size=Total størrelse
Unassign ALL devices to delete this pool=Fjern tildelingen av **alle** disker for å slette denne diskgruppen
Unassigned Devices=Ikke tilordnede enheter
Unavailable - disk must be spun up=Utilgjengelig - disken må spinnes opp
unavailable no parity-check entries logged=utilgjengelig (ingen paritetskontroll er loggført)
Unavailable=Utilgjengelig
Unclean shutdown detected=Uren avslutning oppdaget
Unmountable disk present=Umonterbar disk tilstede
Unmountable disks present=Umonterbare disker tilstede
Unmountable Encrypted volume present=Umonterbar: Kryptert volum tilstede
Unmountable Missing encryption key=Umonterbar: Mangler krypteringsnøkkel
Unmountable No file system=Umonterbar: Ingen filsystem
Unmountable No pool uuid=Umonterbar: Ingen diskgruppe uuid
Unmountable not btrfs pool=Umonterbar: ingen btrfs diskgruppe
Unmountable Volume not encrypted=Umonterbar: Volumet er ikke kryptert
Unmounted=Umontert
Upgrading diskswapping parity=Oppgraderer disk/bytter paritet
Use ASCII characters from space to tilde=Bruk **ASCII** tegn fra mellomrom til tilde
Use Default=Bruk standard
Use default=Bruk standard
Use only lowercase with no special characters or leadingtrailing digits=Kun små bokstaver uten spesielle tegn
use printable characters only=Bruk kun utskriftvennlige tegn
Used=Brukt
Value=Verdi
WARNING canceling may leave the array unprotected=ADVARSEL: avbryting kan føre til at arrayet blir ubeskyttet
Warning disk temperature threshold=Advarsel: disk temperaturgrense
Warning disk utilization threshold=Advarsel: disk bruksgrense
WARNING=ADVARSEL
Warranty period=Garantiperiode
will activate a clean system power down=Skrur av systemet på en ren måte
will activate a clean system reset=Restarter systemet på en ren måte
will bring the array on-line and start Clearing new data disks=vil starte arrayet og begynne **sletting** nye datadisker
will bring the array on-line and start Parity-Check=vil starte arrayet og begynne en **paritetskontroll**
will bring the array on-line and start Parity-Sync andor Data-Rebuild=vil starte arrayet og begynne en **paritetskontroll** og/eller **paritetssynkronisering**
will bring the array on-line=vil starte arrayet
will copy the parity information to the new parity disk=vil kopiere paritetsinformasjonen til den nye paritetsdisken
will create a file system in all Unmountable disks=Vil opprette et filsystem på alle umonterbare disker
will delete the encryption keyfile=vil slette krypteringsnøkkelen
will disable the missing disk and then bring the array on-line Install a replacement disk as soon as possible=vil deaktivere den manglende disken og sette array online. Installer en erstatningsdisk så fort som mulig
will expand the file system of the data disk if possible then bring the array on-line and start Data-Rebuild=vil ekspandere filsystemet på datadiskene (om mulig); så vil array kjøres online og starte Data-rebygging
will immediately clear all disk statistics=vil umiddelbart fjerne all diskstatistikk
will immediately invoke the Mover=vil umiddelbart starte Mover
will immediately spin down all disks=vil umiddelbart spinne ned alle disker
will immediately spin up all disks=vil umiddelbart spinne opp alle disker
will pause Data-Rebuild=vil pause datagjennoppbygging
will pause Disk-Clear=vil pause disk-tømming
will pause Parity-Check=vil pause paritetssjekk
will pause Parity-Sync=vil pause paritetssynkronisering
will pause Read-Check=vil pause lesessjekk
will pause the Clearing=vil pause slettingen
will pause the Parity-Check=vil pause paritetskontrollen
will pause the Parity-SyncData-Rebuild=vil pause paritetssynkroniseringen/datagjenopprettingen
will pause the Read-Check=vil pause lesesjekken
will record all disk information and bring the array on-line=vil ta opp all diskinformasjon og starte arrayet
will record all disk information, bring the array on-line, and start Parity-Sync=vil ta opp all diskinformasjon og starte arrayet og begynne en paritetssynkronisering
will remove the missing cache disk and then bring the array on-line=vil fjerne den manglende bufferdisken og starte arrayet
will resume Data-Rebuild=vil fortsette datagjennoppbygging
will resume Disk-Clear=vil fortsette disk-tømming
will resume Parity-Check=vil fortsette paritetssjekk
will resume Parity-Sync=vil fortsette paritetssynkronisering
will resume Read-Check=vil fortsette lesessjekk
will resume the paused Clearing=vil fortsette sletting
will resume the paused Parity-Check=vil fortsette paritetskontrollen
will resume the paused Parity-SyncData-Rebuild=vil fortsette paritetssynkroniseringen/datagjenopprettingen
will resume the paused Read-Check=vil fortsette lesesjekken
will start Clearing new data disks=vil starte **slettingen** av nye disker
will start Parity-Check=vil starte **paritetskontrollen**
will start Parity-Sync andor Data-Rebuild=vil starte paritetssynkroniseringen og/eller datagjenopprettingen
will start Read-Check of all array disks=vil starte lesessjekken på alle arraydisker
will stop Clearing=vil stoppe slettingen
will stop Data-Rebuild=vil stoppe datagjennoppbygging
will stop Disk-Clear=vil stoppe disk-tømming
will stop Parity-Check=vil stoppe paritetssjekk
will stop Parity-Sync=vil stoppe paritetssynkronisering
will stop Parity-SyncData-Rebuild=vil stoppe aritetssynkroniseringen/datagjenopprettingen
will stop Read-Check=vil stoppe Lesesjekk
will stop the Parity-Check=vil stoppe paritetskontrollen
will stop the Read-Check=vil stoppe lesesjekken
will take the array off-line=vil stoppe arrayet
Worst=Verste
Write corrections to parity=Skriv korreksjoner til paritet
Writes=Skriving
Wrong key=Feil nøkkel
Wrong Pool State=Feil Pool status
xfs_repair status=xfs reparasjonsstatus
You may not add new disks and also remove existing disks=Du kan ikke legge til og fjerne disker samtidig
your server=din server
zfs pool status=ZFS status
zfs=zfs


; Sleep plugin translations
Check this=Sjekk dette
for more information=for mer informasjon
Make sure your server supports S3 sleep=Sørg for at serveren din støtter S3 sleep
Sleep will immediately put the server in sleep mode=**Hvilemodus** vil umiddelbart sette serveren i hvilemodus
Sleeping=Hvilemodus
System in sleep mode=System i hvilemodus
This will put the system in sleep mode=Dette bil sette systemet i hvilemodus
wiki entry=wiki-innlegg

; Note: December 8, 2024 - 52 missing translations
Add Subpool=
Add ZFS Subpool=
After renaming the pool, check that your shares are assigned to the proper primary and secondary storage locations=
After upgrading the volume may not be mountable in previous versions of Unraid=
Attributes not available=
btrfs filesystem usage=
cache - Cache Devices=
Critical NVME temperature threshold=
Critical SSD temperature threshold=
dedup - Deduplication Tables=
Device contents invalid, in standby mode spun-down=Device contents invalid, in standby mode (spun-down)
Device contents invalid=
Device is disabled=
Device is missing disabled=Device is missing (disabled)
Dirty log detected=
File system corruption detected=
Fix=
Identity is not available=
logs - ZFS Intent Log=
Missing pool disk=
No file system corruption detected=
Power=
raid0=
raid1=
raid10=
raid1c3=
raid1c4=
raid5=
raid6=
raidz=
raidz2=
raidz3=
Renaming the pool will change the share storage allocations=
spares - Hot Spares=
special - Special Allocation Class=
The ZFS volume will be upgraded=
This operation cannot be reversed=
To confirm type %s=To confirm type: %s
Unmountable Unsupported or no file system=Unmountable: Unsupported or no file system
Upgrade Pool=
W=
Warning NVME temperature threshold=
Warning SSD temperature threshold=
While there is some risk, if it is not possible to first mount the filesystem to clear the log, zeroing it is the only option to try and repair the filesystem, and in most cases it results in little or no data loss=
will bring the array on-line and start Data-Rebuild=will bring the array on-line and start **Data-Rebuild**
will bring the array on-line and start Disk-Clear of new data disks=will bring the array on-line and start **Disk-Clear** of new data disk(s)
will bring the array on-line and start Parity-Sync=will bring the array on-line and start **Parity-Sync**
will remove the missing pool disk and then bring the array on-line=
will start Data-Rebuild=will start **Data-Rebuild**
will start Disk-Clear of new data disks=will start **Disk-Clear** of new data disk(s)
will start Parity-Sync=will start **Parity-Sync**
Zero Log=
