12 hours=12 timer
24 hours=24 timer
8023ad=8023ad
Active Directory Settings=Active Directory Instillinger
Active Directory=Active Directory
active-backup=
AD account login=AD konto #usikker#
AD account password=AD passord
AD domain name=AD domene
AD initial group=AD opprinnelig gruppe
AD initial owner=AD opprinnelig eier
AD join status=AD medlems status
AD short domain name=AD kort domenenavn
Add Route=Legg til rute
Add VLAN=Legg til VLAN
Agent function=Agent funksjon
Agents=Agenter
Alerts=Alarmer
and, the first and last characters must be alphanumeric=og, første og siste tegn må være alfanumerisk
and=og
APC UPS Daemon user manual=APC UPS Daemon brukermanual
APCsmart=APCsmart
Apply to activate VMs after Array is Started=Bruk for å aktivere VMs etter at array er startet
Array must be Stopped to change=Array må **Stopped** for å endre
Array status notification=Array status varsling
Array status=
Assignment error=Tildelingsfeil
Attention=Merk følgende
Attribute=Egenskap
Authentication method=Autentiseringsmetode
Available notifications=Tilgjengelige varsler
balance-alb=
balance-rr=
balance-tlb=
balance-xor=
Bar color - Text=Bar (color) - Text
Bar color=
Bar gray - Text=Bar (gray) - Text
Bar gray=Bar (gray)
Battery Charge=Batterilading
Battery level to initiate shutdown=Batterinivå for iverksetting av automatisk nedstengning
bfq=
Bonding members of=
Bonding mode=
Both=Begge
bottom-left=bunn-venstre
bottom-right=bunn-høyre
Bridging members of=
broadcast=Kringkastning
Browser=Utforsker
btrfs filesystem show=vis btrfs filsystem
btrfs scrub status=
Cache disk not enabled=Buffer disk ikke akivert
Cache Settings=Buffer innstillinger
Cannot provision cert that would overwrite your existing custom cert at=Kan ikke skaffe **sertifikat** som kan overskrive dit eksisterende spesial sertifikat
Cannot renew cert until within 30 days of expiry=kan ikke fornye sertifikat utenfor 30 dager før utløpsdato
center=senter
Certificate expiration=sertifikat utløpsdato
Certificate issuer=sertifikat utsteder
Check cable=Sjekk kabel
Check four times a day=Sjekk fire ganger daglig
Check once a day=Sjekk en gang daglig
Check once a month=Sjekk en gang i måneden
Check once a week=Sjekk en gang i uka
Check twice a day=Sjekk to ganger daglig
Click here to see the Unraid Wiki for more information=Klikk her for å se Unraid Wiki for mer informasjon
Click to invoke the Mover=Klikk for å starte Mover
Click to select PNG file=Klikk for å velge PNG fil 
Click to Select=Klikk for å velge
configuring interface=konfigurering brukergrensesnitt
Confirm array stop command=Bekreft array stopp komando
Confirm reboot powerdown commands=Bekreft omstart/nedstengnings komando
Confirm sleep command=Bekreft dvale komando
Confirmations=Bekreftelse
Container=Kontainer
Content=Innhold
Correct file system errors=
CPU Isolation A reboot is required to apply changes=CPU Isolasjon: Omstart er nødvendig etter endring
CPU isolation is prohibited while system is running in SAFE MODE=CPU isolasjon er ikke tillatt mens systemet er i SIKKER MODUS
CPU Isolation=CPU Isolasjon
CPU Pinning Docker=CPU Låsing Docker
CPU Pinning VM=CPU Låsing VM
CPU Pinning=CPU Låsing
Current date and time=Nåværende dato og tid
Custom attributes use comma to separate numbers=Egendefinerte egenskaper (bruk komma for å separere nummere)
Custom banner=Spesial definert banner
Custom UPS cable=Spesial UPS kabel
Custom=Spesial
custom=spesial
D comma G dot=D comma : G dot
D comma G none=D comma : G none
D comma G space=D comma : G space
D dot G comma=D dot : G comma
D dot G none=D dot : G none
D dot G space=D dot : G space
Daily=daglig
Date and Time=dato og tid
Date format=Datoformat
Day of the month=Dag av måneden
Day of the week=dag av uken
Day, D Month YYYY= Dag, D Måned ÅÅÅÅ
Day, DD.MM.YYYY= Dag, DD.MM.ÅÅÅÅ
Day, DD-MM-YYYY=Dag, DD-MM-ÅÅÅÅ
Day, MMDDYYYY=Dag, MM/DD/ÅÅÅÅ
Day, Month D, YYYY=Dag, Måned D, ÅÅÅÅ
Day, YYYY Month D=Dag, ÅÅÅÅ Måned D
Day, YYYY-MM-DD=Dag, ÅÅÅÅ-MM-DD
DD-MM-YYYY=DD-MM-ÅÅÅÅ
Default appdata storage location= Standard appdata lagrings lokasjon
Default critical disk temperature threshold=Standard kritisk disk temperatur nivå
Default critical disk utilization threshold= Standard kritisk disk bruk nivå
Default file system=Standard filsystem
Default ISO storage path=Standard ISO lagrings lokasjon
Default network bridge=Standard netverksbro
Default partition format=Standard partisjonsformat
Default SMART attribute notifications=Standard SMART egenskap varsling
Default SMART controller type=Standard SMART kontroller type
Default SMART notification tolerance level=Standard SMART varsel toleransenivå
Default SMART notification value=Standard SMART varsel nivå
Default spin down delay=Standard Spin down forsinkelse
Default VM storage path=Standard VM lagrings lokasjon
Default warning disk temperature threshold=Standard disk temperatur advarsel nivå
Default warning disk utilization threshold=Standard disk bruk advarsel nivå
Default Windows VirtIO driver ISO=Standard Windows VirtIO driver ISO
Define a TLS certificate=Definer et TLS sertifikat
Delete Image File=Slett Bildefil
Delete VLAN=Slett VLAN
Desired MTU=Ønsket MTU
Detailed=Utvidet
Device=Enhet
DHCP pool=DHCP pool
Disk Settings=Disk Instillinger
Display array totals=Vis array total
Display device name=Vis enhetsnavn
Display position=Vis position
Display Settings=Vis innstillinger
Display world-wide-name in device ID=Vis world-wide-name i enhetsID
Docker LOG maximum file size=Docker LOGG Maks størrelse
Docker LOG number of files=Docker LOGG antall filer
Docker LOG rotation= Docker LOGG rotasjon
Docker only=Bare docker
Docker service= 
Docker update notification=Docker oppdateringsvarsel
Docker update=Docker oppdatering
Docker vDisk location=Docker vDisk lokasjon
Docker vDisk size=Docker vDisk størrelse
Docker version=Docker versjon
Docker volume info=Docker volume informasjon
Docker=Docker
Download Windows VirtIO driver ISO=Last ned Windows VirtIO driver ISO
Downstream=
Drag-n-drop a PNG file or click the image at the left=Dra-og-slipp en PNG fil eller venstre-klikk bildet
Dumb=Dum
Dynamix color theme=Dynamix farge tema
Email recipients=Email mottaker
Email subject prefix=Email emne
Email=
Enable auto start=Aktiver auto oppstart
Enable bonding=Aktiver bonding
Enable bridging=Aktiver bro 
Enable disk shares=Aktiver disk deling
Enable Docker=Aktiver Docker
Enable NetBIOS=Aktiver NetBIOS
Enable NFS=Aktiver NFS
Enable SMB=Aktiver SMB
Enable spinup groups=Aktiver spinup grupper
Enable user shares=Aktiver bruker mapper
Enable VLANs=Aktiver VLANs
Enable VMs=Aktiver VMs	
Enable WSD=Aktiver WSD
Enhanced macOS interoperability=Forbedret macOS interoperabilitet
Enter route + gateway + metric=Skriv rute + gateway + metric
Ether=
Ethernet Port=Nettverksport
Event=Hendelse
Every day=Hver dag
Every month=Hver måned
Every week=Hver uke
exceeds Disk Shutdown=
Excluded disks=Eksluderte disker
Execution error=Kunne ikke gjenomføre handling
Failed to stop=Kunne ikke stoppe
Failure to do so may result in your docker image suffering corruption at a later time=Unnlatelse av å gjøre det kan føre til at dockerbildet ditt blir ødelagt på et senere tidspunkt
First day=Første dag
First week=Første uke
Font size=Font størrelse
Fourth week=Fjerde uke
FTP server=
FTP users=FTP bruker(e)
Gateway=
gateway name or address=gateway navn og adresse
Global Share Settings=Globale delings innstillinger
Global SMART Settings=Globale SMART Instillinger
has been created on unraidnet=har blitt generert på unraidnet
has been updated for unraidnet=har blitt oppdatert for unraidnet
Header custom background color=Overskrifts bakgrunnsfarge
Header custom text color=Overskrifts tekstfarge
Header menu=Overskriftsmeny
HHMM=HH:MM
Hibernate VMs=sett VMs i dvale
Hide dot files=Skjul dot filer
Host access to custom networks= Verts tilgang til egendefinerte nettverk
hosts=Verter
Hourly=Time
HTML color code of 3 or 6 hexadecimal digits=HTML fargekode på 3 eller 6 heksadesimale sifre
HTTP port=
HTTPS port=
Huge=Stor
Identification=Identifikasjon
Importance=Viktihet
Included disks=Inkluderte Disker
Interface description=Beskrivelse av brukergrensesnitt
Interface Rules=brukergrensesnitt regler
Invalid email address=Ugyldig email adresse
Invalid IPv4 gateway=U IPv4 gateway
Invalid IPv4 range=Ugyldig IPv4 adresse 
Invalid IPv4 subnet=Ugyldig IPv4 Subnett
Invalid IPv6 gateway=Ugyldig IPv6 gateway
Invalid IPv6 range= Ugyldig IPv6 adresse
Invalid IPv6 subnet=Ugyldig IPv6 Subnett
Invalid pool address=Ugyldig adresse pool
Invalid subnet size=Ugyldig subnett størrelse
IPv4nn or IPv6nn route=IPv4/nn eller IPv6/nn rute
IPv4 address A.B.C.D=IPv4 adresse A.B.C.D
IPv4 address assignment=IPv4 adresse tildeling
IPv4 address=IPv4 adresse
IPv4 custom network on interface=IPv4 
IPv4 default gateway=IPv4 standard gateway
IPv4 DNS server assignment=IPv4 DNS server tildeling
IPv4 DNS server= IPv4 DNS server
IPv4 IPv6= IPv4 IPv6
IPv4 only=Kun IPv4 
IPv6 address assignment=IPv6 adresse tildeling
IPv6 address nnnnxxxxyyyy=IPv6 adresse nnnn:xxxx::yyyy
IPv6 address=IPv6 adresse
IPv6 custom network on interface=IPv6 egendefinerte nettverk på nettverksinterface
IPv6 default gateway=IPv6 standard gateway
IPv6 DNS server assignment=IPv6 DNS server tildeling
IPv6 DNS server=IPv6 DNS server 
IPv6 only=Kun IPv6
IPv6 privacy extensions=IPv6 personverns utvidelser
is down=er nede
Isolated CPUs=Isolerte CPU kjerner
Isolation=Isolasjon
Key=Nøkkel
kyber=
Language=Språk
Language update=Språk oppdatering
Language update notification=Språk oppdateringsvarsel
Large=Stor
Last day=Siste dag
Last week=Sist uke
LE Cert Provisioned successfully=LE sertifikat tildelt suksessfullt
Libvirt Log=Libvirt Logg
Libvirt storage location=Libvirt lagrings lokasjon
Libvirt version=Libvirt versjon
Libvirt volume info=Libvirt volum informasjon
License key required=Lisens nøkkel påkrevet
List of VLANs contains duplicate VLAN numbers=Listen med VLAN nummere inneholder duplikater 
Listing height=Oppføringshøyde
Local master=Lokal master
Local syslog folder=Lokal syslog mappe
Local syslog maximum file size=Lokal syslog maks fil størrelse
Local syslog number of files=Lokal syslog antall filer
Local syslog rotation=Lokal syslog rotasjon
Local syslog server=Lokal syslog server
Local TLD=Lokal TLD
Lost communication=Kommunikasjon tapt
MAC address=MAC adresse
Mail server port=Mail server port
Mail server=Mail server
Management Access=Ledelsestilgang
Manual=Brukerdokumentasjon
may conflict with well-known services=kan komme i konflikt med kjente tjenester
member of=medlem av
Metric=
Mirror syslog to flash=Speil syslog til minne
Missing subnet size=Manglende subnett størrelse
MM-DD-YYYY=MM-DD-ÅÅÅÅ
ModBus=
Modify with caution unable to validate path until Array is Started=Forsiktig: kan ikke validere sti før array er startet
Month of the year=Måned i året
Monthly=Månedlig
Move now=Flytt nå
Mover logging=Flytte logging
Mover Settings=Flytter innstillinger
Mover schedule=Flytter tidsplan
mq-deadline=mq-tidsfrist
Multi-function=Multifunksjon
must be a file directory provided=må være en forhåndsdefinert fil lokasjon
Net=Net
Network protocol=Nettverksprotokoll
Network Services=Nettverkstjenester
Network Settings=Nettverksinntillinger
Never check=Aldri sjekk
Never send=Aldri send
New date and time=Ny tid og dato
NFS=
No battery detected=Ingen batteri gjenkjent
No Cache disk present=Ingen buffer disk tilgjengelig
No CPU pinning available. Docker service must be started=Ingen CPU låsning tilgjengelig Docker tjenesten må startes
No CPU pinning available. VM service must be started=Ingen CPU låsning tilgjengelig VM tjenesten må startes
No Parity disk present=Ingen paritets disk tilgjengelig
Nominal Power=Nominell strøm
Non-recommended port=Ikke rekomandert port
Non-tabbed=Ikke-Faner
Not allowed to assign ZERO cores=Ikke tillatt med NULL kjerner
Not compatible with NetBIOS=Ikke kompatibel med NetBIOS
not configured=ikke konfigurert
not set=ikke konfigurert
Nothing to do=Ingenting og gjøre
Notices=merknader
Notification Agents=Varslingsagenter
Notification entity=Varslingsenhet
Notification Settings=Varslingsinnstillinger
Notifications display=Varslings visning
NTP server=
Number format=Nummer format
Number scaling=Nummer skalering
Obtaining DNSv4 server=Mottar DNSv4 server
Obtaining DNSv6 server=Mottar DNSv6 server
Obtaining IPv4 address=Mottar IPv4 adresse
Obtaining IPv4 gateway=Mottar IPv4 gateway
Obtaining IPv6 address=Mottar IPv6 adresse
Obtaining IPv6 gateway=Mottar IPv6 gateway
obtaining=Mottar
On battery=Batteridrift
One or more paths do not exist=En eller flere stier eksisterer ikke
Online boost=Online (boost)
Online trim=Online (trim)
Online=
Only alphanumeric characters=Kun alfanumeriske tegn
Only PNG images are allowed=Kun PNG bilder er tillatt
Oops=
optional metric lowest is preferred=egendefinert egenskap (lavest - best)
optional metric lowest is preferred, 0 is no default gateway=egendefinert egenskap (lavest - best, 0 er standard gateway)
Page view=Side visning
Parity Check=Paritets sjekk
Password=Passord
Path does not exist=Sti eksisterer ikke
PCIe ACS override=PCIe ACS Overstyring
PCnet=
Placement of Users menu=Plassering av bruker meny
Please disable the VM function=Vennligst deaktiver VM funksjonen
Please do this NOW=Vennligst gjør NÅ
Please enter a valid gateway=Vennligst fyll inn en gyldig gateway
Please enter a valid range=Vennligst fyll inn en gyldig adressepool
Please enter a valid sending email address=Vennligst fyll inn en gyldig epost for sending
Please enter a valid subnet=Vennligst fyll inn et gyldig subnett
Plugins update notification=Plugins oppdateringsvarsel
Plugins update=Plugins oppdatering
Pool address is out of range=Adresse er utenfor adressepool
Pool subnet size is not defined=Adressepool subnett er udefinert
Pool subnet size is too large=Adressepool subnett er for stort
Port Down=Port nede
Port Up=Port oppe
Preserve user defined networks=Behold bruker definerte nettverk
Preset service=Forhåndsdefinert tjeneste
Priority in header=Prioritet i overskrift
Protocol=Protokoll
Provision=Provisjonere
readmodifywrite=Lese/redigere/skrive
reconstruct write=Rekonstruerende skriving
Refreshing=Oppdaterer
Registration key required=Lisens nøkkel påkrevd
Remote syslog server=Ekstern syslog server
Remove Windows VirtIO driver ISO=Fjern Windows VirtIO driver ISO
resolution=oppløsning
Route=Rute
Routing Table=Ruting tabell
Rules=Regel
Runtime left to initiate shutdown=Gjenstående tid til avslutning iverksettes 
Runtime Left=Gjenstående tid
Samba extra configuration=Samba ekstra konfigurering
Scheduled parity check=Planlagt paritets sjekk
Scheduler=Planlegger
Scrub=Skrubb
Second week=Andre uka
See Help for more details and workarounds=Se Hjelp for flere detaljer og workarounds
see interface=Se brukergrensesnitt
Send every hour=Send hver time 
Send every two hours=Send annenhver time
Send four times a day=Send fire ganger daglig
Send once a day=Send en gang per dag
Send once a month=Send en gang per måned
Send once a week=Send en gang per uke
Send three times a day=Send tre ganger daglig
Send twice a day=Send to ganger daglig
Sending email address=Avsender epost adresse
Server name=Server navn
Server was unable to provision SSL certificate=Server kunne ikke ikke provisjonere SSL sertifikat
Setting disabled in safe mode=Instilling deaktivert i **sikkermodus**
Settings menu=Instillinger
Show array utilization indicator=Vis array utnyttelses indikator
Show banner=Vis overskrift
Show Dashboard apps=Vis Dashboard applikasjoner
Shutdown time-out=Avsluttnings time-out
Shutdown VMs=Avslutt Virtuelle Maskiner
Simple=Enkle
Small=Liten
Smart=
SMB Extras=SMB ekstra
SMB Settings=SMB Instillinger
SMB=
SMTP Settings=SMTP innstillinger
SNMP=
Sorry, an error occurred in processing your SSL certificate=Beklager, en feil inntraff når vi prossesserte ditt SSL sertifikat
Sorry, an error occurred updating unraidnet DNS records=Beklager, en feil inntraff under oppdateringav unraidnet DNS 
SSH port=
Start APC UPS daemon=
Start page=Startsside
Static=Statisk
Stop %s to make changes, see=Stopp **%s** for å gjøre endringer, se
Store notifications to flash=Lagre varsler til minne
Subject=Emne
Subnet=Subnett
success=suksess
Summarized=Oppsummering
Syslog Server=
System notifications=System varsler
System Setting=System innstillinger
System Settings=System Instillinger
Tabbed=Faner
TELNET port=
Temperature unit=Temperatur enhets
Template Authoring Mode=Mal redigeringsmodus
Test running=Test Kjører
Text - Bar color=Tekst - Bar (color)
Text - Bar gray=Tekst - Bar (gray)
Text=Tekst
Third week=Tredje uke
This is required to create VMs in KVM=Dette er påkrevet for Virtuelle Maskiner i KVM
this mode requires a network switch with proper setup and support=denne modusen krever en nettverksswitch med rett konfigurasjon og støtte 
Time format=Tidsformat
Time of the day=Tid av dagen 
Time on battery before shutdown=Gjenstående tid på batteridrift før avslutning
Time zone=Tidssone
time-out=
Timestamp=Tidsstempel
TLS certificate location=TLS sertifikat lokasjon
Toggle thread to containers=Veklse tråder til kontainere
top-left=topp-venstre
top-right=top-høyre
Tunable enable Direct IO=Tunable (enable Direct IO)
Tunable enable NCQ=Tunable enable (NCQ)
Tunable fuse_remember=Tunable (fuse_remember)
Tunable md_num_stripes=Tunable (md_num_stripes)
Tunable md_queue_limit=Tunable (md_queue_limit)
Tunable md_sync_limit=Tunable (md_sync_limit)
Tunable md_write_method=Tunable (md_write_method)
Tunable nr_requests=Tunable (nr_requests)
Tunable poll_attributes=Tunable (poll_attributes)
Tunable scheduler=Tunable (scheduler)
Tunable support Hard Links=Tunable (support Hard Links)
Turn off UPS after shutdown=
; Keep the original plugin name in settings
Unassigned Devices=Utildelte enheter
Unraid OS update notification=Unraid OS oppdateringsvarsel
Unraid OS update=Unraid OS oppdatering
Update DNS=Oppdater DNS
updating=Oppdaterer
Upon host shutdown=Ved Verts avslutning
UPS cable=UPS kabel
UPS Details=UPS Detaljer 
UPS Load=UPS last
UPS Settings=UPS Instillinger
UPS Status=UPS Status
UPS type=UPS type
USB=
Use cache device=Bruk buffer enhet
Use NTP=Bruk NTP
Use SSH=Bruk SSH
Use SSLTLS=Bruk SSL/TLS
Use STARTTLS=Bruk STARTTLS
Use TELNET=Bruk TELNET
Use UPnP=Bruk UPnP
Used Free columns=Brukt / Ubrukt kolonner
User Preferences=Bruker innstillinger
User shares not enabled=Bruker mapper ikke akivert
User Utilities=Bruker verktøy
Username=Brukernavn
user-set=bruker-satt
value must be a number=verdi må være et nummer
Value=Verdi
Very large=Veldig stor
Very small=Veldig liten
VFIO allow unsafe interrupts=VIFO tillat usikre avbrytelser
View libvirt log=Vis libvirt logger
view=vis
VLAN assignment mismatch=VLAN tildelings forvirring
VLAN number=VLAN nummer
VM Manager=
VM shutdown time-out=VM avslutnings time-out
VM=
VMs only=Kun VM
VMs will be available after Array is Started=Virtuelle maskiner blir tilgjengelige etter at arrayet er startet
VPN Manager=
Warnings=Advarsler
Watts=
Week of the month=Uke av måned
Weekly=Ukentlig 
Workgroup Settings=Arbeidsgruppe innstillinger
Workgroup=Arbeidsgruppe
Write corrections to parity disk=Skriv rettelser til paritets disk
WSD options experimental=WSD Instillinger EKSPRIMENTELL
Yearly=Årlig
Your existing Docker image file needs to be recreated due to an issue from an earlier beta of Unraid 6=Din eksisterende Docker bildefil må gjenskapes grunnet et problem med en tidligere beta versjonav Unraid 6
Your hardware does not have Intel VT-x or AMD-V capability=Din hardware har ikke støtte for intel VT-x eller AMD-V
Your Lets Encrypt SSL Certificate has been provisioned and a DNS record for local IP address=Ditt Lets Encrypt SSL sertifikat har blitt provisjonert og en DNS-post for din lokale IP adresse har blitt generert 
Your Lets Encrypt SSL Certificate has been renewed=Ditt Lets Encrypt SSL sertifikat har blitt fornyet
Your local IP address=Din lokale IP adresse
Your router or DNS server has DNS rebinding protection enabled, preventing=Din router eller DNS server har gjenbindende beskyttelse, som forhindrer
YYYY-MM-DD=ÅÅÅÅ-MM-DD

; New entries - 2021-03-14
Activate=Aktiver
Activated=Aktivert
Activating=Aktiverer
Allow Remote Access=Tillat Fjerntilgang
Applying=Tar i bruk
Apply to activate Docker after Array is Started=Ta i bruk for for å aktivere Docker etter at Array er startet
Are you sure you want to erase all change history in both local and unraidnet remote=Er du sikker på at du vil slette all endringslogg i både lokal og unraid.net ekstern?
Are you sure you want pause communication with your remote flash backup on unraidnet=Er du sikker på at du vil stoppe kommunikasjonen med den eksterne flash-sikkerhetskopien på unraid.net?
btrfs vDisk=
Changes=Endringer
Checking=Sjekker
Deactivate=Deaktiver
Deactivating=Deaktiverer
Delete directory=Slett mappe
Delete vDisk file=Slett vDisk fil
directory=mappe
Disabled until you Provision an unraidnet SSL Cert and set SSL-TLS to Auto=Deaktivert til du gir en unraid.net SSL-sertifisering og setter SSL-TLS til Auto
Disabled until your root user account is password-protected=Deaktivert til din ROOT bruker er passord-beskyttet
Docker data-root=
Docker directory=Docker mappe
Docker Stop Timeout=Docker Stopper Timeout
Docker will be available after Array is Started=Docker blir tilgjengelig etter at Array er startet
Flash backup=
Header show description=Overskrift vis beskrivelse
Join=Bli med
Leave=Forlat
Libvirt vdisk size=Libvirt vDisk størrelse
Loading=Laster
MAC address mismatch=MAC adresse konflikt
More information=Mer informasjon
Mover is running=Flytter kjører
name or ip address=navn eller IP adresse
Not activated=Deaktivert
Not up-to-date=Ikke oppdatert
Please note that the flash backup is not encrypted at this time=Vær oppmerksom på at flash-sikkerhetskopien ikke er kryptert på dette tidspunktet.
Please Reboot system to make new rules active=Vennligst ** Start ** systemet for å gjøre nye regler aktive
QEMU version=QEMU versjon
Reinitialize=Reinitialisere
Reinitializing=Reinitialiserer
Remark configure your router with port forwarding of port=Merknad: Konfigurer ruteren din med videresending av port
Rules contain duplicate MAC address assignments=Reglene inneholder dupliserte MAC-adressetildelinger
Send crash information to Unraid developers=Send krasjinformasjon til Unraid-utviklere
Test=
This Unraid Server was unreachable from the outside=Denne Unraid-serveren var utilgjengelig utenfra
to=til
Unable to register this Unraid Server=Kan ikke registrere denne Unraid-serveren
Unraidnet Status=Unraid.net Status
Updating=Oppdaterer
Use image name dockerimg or docker-xfsimg or select a folder=Bruk bildenavn docker.img eller docker-xfs.img eller velg en mappe
WAN Port=
xfs vDisk=
Your server has been registered=Serveren din er registrert
Your Unraid Server is reachable from the internet=Unraid Server er tilgjengelig fra internett
