Add Share=Legg til delt mappe
All files encrypted=Alle filer er kryptert
All files protected=Alle filer er beskyttet
All files unprotected=Alle giler er ubeskyttet
Allocation method=Tildelingsmetode
Array must be Started to view Shares=Arrayet må være **startet** for å se delte mapper
Automatically split any directory as required=Del opp alle kataloger automatisk
Automatically split only the top five directory levels as required=Del automatisk bare de fem øverste katalognivåene etter behov
Automatically split only the top four directory levels as required=Del automatisk bare de fire øverste katalognivåene etter behov
Automatically split only the top level directory as required=Del automatisk bare toppnivåkatalogen etter behov
Automatically split only the top three directory levels as required=Del automatisk bare de tre øverste katalognivåene etter behov
Automatically split only the top two directory levels as required=Del automatisk bare de to øverste katalognivåene etter behov
Clean Up=Rydd opp
CLEAN UP=RYDD OPP
Comments=Kommentarer
Compute All=Beregn Alle
Compute=Beregn
Disk Shares=Delte disker
Do not use pool names=Ikke bruk diskgruppenavn
Do not use reserved names=Ikke bruk reserverte navn
Enable Copy-on-write=Skru på "Copy-on-write"
Enter a name for the share=Gi den delte mappen et navn
Excluded disks=Ekskluderte disker
Exclusive access=Eksklusiv tilgang
Export=Eksporter
Fill-up=Fyll opp
Free=Ledig
has been deleted=har blitt slettet
HDD=HDD
High-water=High-water
Included disks=Inkluderte disker
Invalid Characters=Ugyldige tegn
Invalid share name=Ugyldig mappenavn
Manual do not automatically split directories=Manuell: ikke del opp kataloger automatisk
Minimum free space=Minimum ledig plass
Missing share name=Mangler mappenavn
Most-free=Most-free
Mover action=Mover handling
Mover takes no action=Mover gjør ingenting
Mover transfers files from array to cache=Mover flytter filer fra arrayet til buffer
Mover transfers files from cache to array=Mover flytter filer fra buffer til arrrayet
Mover transfers files from Primary storage to Secondary storage=Mover overfører filer fra primær lagring til sekundær lagring
Mover transfers files from Secondary storage to Primary storage=Mover overfører filer fra sekundær lagring til primær lagring
next user share=Neste delte mappe
No unused share configurations present=Ingen ubrukte delingskonfigurasjoner tilstede
Not used=Ikke brukt
Only=Kun
Prefer=Foretrekk
previous user share=forrige delte mappe
Primary storage %s=Primær lagring %s
Primary storage for new files and folders=Primær lagring (for nye filer og mapper)
Primary storage to Secondary storage=Primær lagring til Sekundær lagring
Read=Les
Recompute=Beregn på nytt
Remove unused share configurations=Fjern ubrukte delingskonfigurasjoner
Removed share configurations=Fjernede delingskonfigurasjoner
Rule=Regel
Secondary storage to Primary storage=Sekundær lagring til primær lagring
Secondary storage=Sekundær lagring
Select cache pool=Velg buffer diskgruppe
Set when adding new share only=Angi når du bare legger til ny delt mappe
Share contains data=Delt mappe inneholder data
Share is empty=Delt mappe er tom
Share is outside the list of designated disks=Delt mappe er utenfor listen av angitte disker
Share name contains invalid characters for ZFS use=Delingsnavnet inneholder ugyldige tegn for ZFS-bruk
Share Settings=Delingsinnstillinger
Share status=Delingstatus
Size=Størrelse
Some or all files unencrypted=Noen eller alle filer er ukryptert
Some or all files unprotected=Noen eller alle filer er ubeskyttet
Split level=Delenivå
SSD=SSD
Storage=Lagring
There are no exportable disk shares=Det er ingen delte disker som er eksporterbare
There are no exportable user shares=Det er ingen delte mapper som er eksporterbare
Time Machine volume size limit=Størrelsesbegrensning på Time Machine-katalogen
Unknown encryption state=Ukjent krypteringsmodus
Use cache pool for new filesdirectories=Benytt buffer diskgruppe for nye filer/kataloger
User Shares=Delte mapper
Write=Skriv
You cannot use the following within share names=Du kan ikke bruke følgende i mappenavn

; Note: April 21, 2025 - 12 missing translations
Free Space will be calculated=
is missing=
it references storage that does not exist=
It references storage that does not exist=
Share is empty and is safe to delete=
Share must be empty to be deleted=
There are no mountable array or pool disks - cannot add shares=
There are no mounted array or pool disks - cannot add shares=
This share is invalid=
Unknown cache usage=
Unknown protection status=
Warning: Configured Pool=
