20 EHCI=2.0 (EHCI)
30 nec XHCI=3.0 (nec XHCI)
30 qemu XHCI=3.0 (qemu XHCI)
Allocation=Allokering
and if using graphics device passthrough it too needs UEFI=og hvis grafikk enhet passthrough brukes, trenger den også UEFI
Are you sure=Er du sikker
Array must be started to view Virtual Machines=Arrayet må være **startet** for å vise Virtuelle Maskiner
Autostart=Autostart
Back=Tilbake
Bus=Buss
Capacity=Kapasitet
Change Icon=Endre Ikon
Cleanup=Rydd opp
Click and Select cdrom image to install operating system=Klikk og Velg cdrom bildefil for å installere operativ system
Config Folder=Konfig Mappe
Copy Paste Domain XML Configuration Here=Kopier og &amp; Lim inn Domene XML Konfigurasjon Her
CPU Mode=CPU Modus
CPUs=CPUer
Create=Opprett
Creating=Oppretter
define the amount memory=definer mengde minne
define the maximum amount of memory=definer maksimum mengde minne
define type of cpu presented to this vm=definer type cpu som presenteres til denne vm
description of virtual machine=beskrivelse av den viretuelle maskinen
Disk devices=Diskenheter
Download Folder=Nedlastningsmappe
Download, Click and Select virtio drivers image=Last ned, Klikk og Velg virtio drivere
Downloading=Laster ned
eg=e.g.
Emulated=Emulert
ETA=
Extracting=Pakker ut
Folder to save the LibreELEC image to=Mappe for å lagre LibreELEC bildefil til
Folder to save the OpenELEC image to=Mappe for å lagre OpenELEC bildefil til
Form View=Skjemavisning
free=Ledig
Graphics Card=Grafikkort
Graphics ROM BIOS=Grafikk ROM BIOS
Graphics=Grafikk
Host Passthrough=Vert Passthrough
Hyperv tweaks for Windows=Hyperv justeringer for Windows
Hyper-V=Hyper-V
i440fx will work for most=i440fx vil virke for de fleste
Icon=Ikon
Initial=Første
Invalid VM to edit=Ugyldig VM til å redigere?? 
ISO storage path doesnt exist=ISO lagringssti finnes ikke
ISO storage path doesnt exist, please create the user share or empty folder first=ISO storage path doesn't exist, please create the user share (or empty folder) first
ISO storage path was empty=ISO lagringssti var tom
keyboard for VNC=tastatur for VNC
LibreELEC Version=LibreELEC Versjon
LibreELEC=LibreELEC
Libvirt Service failed to start=Libvirt Service kunne ikke starte
Logical CPUs=Logiske CPUer
Machine=Maskin
Manual=Manuell
Max=Maks
MD5 verification failed, your download is incomplete or corrupted=MD5 verifisering mislyktes, nedlastingen din er ufullstendig eller ødelagt
mount tag inside vm=monteringstag i vm
My Workstation=Min Arbeidsstasjon
name of mount tag inside vm=navn på monteringstag i vm
Name of virtual machine=Navn på virituell maskin
Network Bridge=Netverksbro
Network MAC=Netverk MAC
Network Model=Nettverksmodell
No Virtual Machines installed=Ingen Virituelle maskiner installert
None available=Ingen tilgjengelige
Not enough free space, need at least=Ikke nok ledig plass, trenger minst
Not running=Kjører ikke
OpenELEC Version=OpenELEC Versjon
OpenELEC=OpenELEC
OS Install CDRom Bus=OS Installerings CDRom Buss
OS Install ISO=OS Installerings ISO
Other PCI Devices=Andre PCI Enheter
OVMF requires a UEFI-compatable OS=OMVG krever et UEFI-kompatibelt OS
OVMF=OMVF
OVMF TPM=
password for VNC=passord for VNC
path of Unraid share=sti til delt mappe
path on Unraid share to save LibreELEC settings=sti på delt mappe for å lagre LibreELEC innstillinger
path on Unraid share to save OpenELEC settings=sti på delt mappe for å lagre OpenELEC innstillinger
Path to ROM BIOS file=Sti til ROM BIOS fil
Please choose a folder the LibreELEC image will download to=Vennligst velg mappen som LibreELEC bildefilen skal lastes ned til
Please choose a folder the OpenELEC image will download to=Vennligst velg mappen som OpenELEC bildefilen skal lastes ned til
Pop-up Blocker is enabled Please add this site to your exception list=Pop-up Blocker is enabled! Please add this site to your exception list
Primary=Hoved
Q35 for a newer machine model with PCIE=Q35 for en nyere maskin med PCIE
QEMU64=QEMU64
random mac, you can supply your own=tilfeldig mac, du kan oppgi din egen
re-generate random mac address=regenerer tilfeldig mac addresse
Remove LibreELEC image=Fjern LibreELEC bildefil
Remove OpenELEC image=Fjern OpenELEC bildefil
Remove this LibreELEC file=Fjern denne LibreELEC filen
Remove this OpenELEC file=Fjern denne OpenELEC filen
SeaBIOS will work for most=SeaBIOS vil virke for de fleste
SeaBIOS=SeaBIOS
Select the BIOS=Velg BIOS
Select the LibreELEC version to use=Velg LibreELEC versjon som skal brukes
Select the machine model=Velg maskin modell
Select the OpenELEC version to use=Velg OpenELEC versjon som skal brukes
Select the USB Controller to emulate=Velg USB Kontroller som skal emuleres
Separate sub-folder and image will be created based on Name=Separat undermappe og bildefil vil bli opprettet basert på Navn
shares=delte mapper
Some OSes wont support USB3=Noen OS støtter ikke USB3
Sound Card=Lydkort
Specify a ISO storage path first=
Start All=Start alle
Start VM after creation=Start VM etter den opprettes
Stop All=Stopp alle
Toggle VM autostart=Veksle VM autostart
type of storage image=type lagringsbildefil
Unknown action=Ukjent handling
Unknown version=Ukjent versjon
Unraid Mount tag=Unraid Monterings tag
Unraid Share=Delt Mappe
Updating=Oppdaterer
USB Controller=USB Kontroller
USB Devices=USB Enheter
vDisk Bus=vDisk Buss
vDisk Location=vDisk Plassering
vDisk Size=vDisk Størrelse
vDisk Type=vDisk Type
vDisks=vDisker
Verifying=
video for VNC=video for VNC
VirtIO Drivers CDRom Bus=VirtIO Drivere CDRom Bus
VirtIO Drivers ISO=VirtIO Drivere ISO
Virtual Machines=Virituelle Maskiner
VM creation error=Feil ved oppretting av VM
VM image deletion error=Feil ved sletting av VM-bilde 
VNC Keyboard=VNC Tastatur
VNC Password=VNC Passord
VNC Video Driver=VNC Video Driver
VNC=VNC
Wasnt able to stop the process=Var ikke i stand til å stoppe prosessen
Windows 7XP=Windows 7/XP
Windows 82012, newer Linux distros=Windows 8/2012, nyere Linux distroer
XML View=XML Visning

; Note: March 1, 2022 - 4 missing translations
